SO        ./textures/purplestone.png

        NO    ./textures/redbrick.png

       WE       ./textures/greystone.png


EA        ./textures/colorstone.png

F 220,100,0


C 225,30,0

            111111111111
            100000000001
            100000000001
            100000000001
            100000000001
            100000000001
            100000000001
            100000000001
            100000000001
            100000000001
            100000000001
11111111111110000000000111111111111111
10000000000000000N00000000000000000001
10000000000000000000000000000000000001
10000000000000000000000000000000000001
10000000000000000000000000000000000001
10000000000000000000000000000000000001
10000000000000000000000000000000000001
10000000000000000000000000000000000001
10000000000000000000000000000000000001
10000000000000000000000000000000000001
10000000000000000000000000000000000001
10000000000000000000000000000000000001
11111111111110000000000111111111111111
            100000000001
            100000000001
            100000000001
            100000000001
            100000000001
            100000000001
            100000000001
            100000000001
            100000000001
            100000000001
            100000000001
            111111111111
