SO        ./path_to_the_south_texture

        NO    ./textures/grass_21_256x256.png

       WE       ./path_to_the_west_texture


EA        ./path_to_the_east_texture

F 220,100,0


C 225,30,0

                      111111111
           11111      100000001
           10001      1000000011111
        11110000111111100000001111111
        1000000000110000000000001
        10110000011100000000000011111
        10010000000000000000000000001
1111111110110000011100000000000011111
100000000011000001110111100111111
11110111111111011100000010001
11110111111111011101010010001
11000000110101011100000010001
10000000000000001100000010001
10000000000000001101010010001
11000001110101011111011110N0111
11110111 1110101 111000010011
11111111 1111111 111111111111
