SO        ./textures/green_light.xpm

        NO    ./textures/tech_0E.xpm

       WE       ./textures/blue_light.xpm

EA        ./textures/yellow_light.xpm

       F     255 , 255 , 255


C 2 , 47 , 56

                    1111     11111
      111   11111   1001    110011
      101   10001   1001    100001
   111101111100011111001111110000111
   10000000000000000000000000000000111
   10000000000000000000000000000000001
   1000000000001111111110000000000000111
111100000000001111111111100000000000000111
100000000000011111111111110000000000000001
100000000000011111111111110000000000000001
100000000000001111111111100000000000000001
111111110000000111111111000000000000000001
100000000000000000000000000000000000000001
1000000000000000000W0000000000000000000011
11111111100000000011100000000000111111111
        1000000000000000010000001
        1100000000111110001000011
1111111  1110000001   1000100001   11111
1000001    10000001   1000100001   10001
1000001    10000001   100010000111111001
1000001111110000001   100010000000000011
1000000000000000001   100010000111111111
1111111111111000001   1000100001
            1000001   10001000011
  1111111   1000001   100010001     1111111
  1000001   1000001   100010001     1000001
  10000011111000001   1000000011111110000011
  10000000000000001   1000000000000000000011
  11111111111111111   111111111111111111111
